00 00 00 00 00 00 00 00
00 00 00 00 00 00 00 00
00 00 00 00 00 00 00 00
00 00 00 00 00 00 00 00
00 00 00 00 00 00 00 00
00 00 00 00 00 00 00 00
00 00 00 00 00 00 00 00
00 00 00 00 00 00 00 00


Chunk1:
00 00 00 00 00 00 00 28
00 00 00 00 00 00 00 28
00 00 00 00 00 00 00 28
00 00 00 00 00 00 00 28
00 00 00 00 00 00 00 28
00 00 00 00 00 00 00 28
00 00 00 00 00 00 00 28
00 00 00 00 00 00 00 28


Chunk2:
00 00 00 00 00 00 00 26
00 00 00 00 00 00 00 00
00 00 00 00 00 00 00 00
00 00 00 00 00 00 00 00
00 00 00 00 00 00 00 00
00 00 00 00 00 00 00 00
00 00 00 00 00 00 00 00
00 00 00 00 00 00 00 00

Chunk3:
16 16 16 16 16 16 16 16
00 00 00 00 00 00 00 00
00 00 00 00 00 00 00 00
00 00 00 00 00 00 00 00
00 00 00 00 00 00 00 00
00 00 00 00 00 00 00 00
00 00 00 00 00 00 00 00
00 00 00 00 00 00 00 00


Chunk4:
19 00 08 00 00 08 00 21
28 00 00 00 00 00 00 34
28 00 00 00 00 00 00 34
26 16 16 16 16 16 16 22
00 00 00 00 00 00 00 00
00 00 00 00 00 00 00 00
00 00 00 00 00 00 00 00
00 00 00 00 00 00 00 00

Chunk5:
19 00 00 00 00 00 00 00
26 19 00 00 00 00 00 00
00 26 19 00 00 00 00 00
00 00 26 16 16 16 16 16
00 00 00 00 00 00 00 00
00 00 00 00 00 00 00 00
00 00 00 00 00 00 00 00
00 00 00 00 00 00 00 00

Chunk6:
34 00 00 00 00 00 00 00
34 00 00 00 00 00 00 00
34 00 00 00 00 00 00 00
22 00 00 00 00 00 00 00
00 00 00 00 00 00 00 00
00 00 00 00 00 00 00 00
00 00 00 00 00 00 00 00
00 00 00 00 00 00 00 00

Chunk7:
21 16 16 16 16 16 16 16
34 00 00 00 00 00 00 00
34 00 00 00 00 00 00 00
34 00 00 00 00 00 00 00
34 00 00 00 00 00 00 00
34 00 00 00 00 00 00 00
34 00 00 00 00 00 00 00
34 00 00 00 00 00 00 00




Tilemap:

1 0 0 0 0 0 0 7
2 3 4 3 5 3 3 6



BossMap:

Chunk1:
54 58 58 58 58 58 58 58
28 00 00 00 00 00 00 00
28 00 00 00 00 00 00 00
28 00 00 00 00 00 00 00
28 00 00 00 00 00 00 00
28 00 00 00 00 00 00 00
28 00 00 00 00 00 00 00
28 00 00 00 00 00 00 00

Chunk2:
28 00 00 00 00 00 00 00
28 00 00 00 00 00 00 00
28 00 00 00 00 00 00 00
28 00 00 00 00 00 00 00
28 00 00 00 00 00 00 00
28 00 00 00 00 00 00 00
28 00 00 00 00 00 00 00
26 16 16 16 16 16 16 16

Chunk3:
58 58 58 58 58 58 58 58
00 00 00 00 00 00 00 00
00 00 00 00 00 00 00 00
00 00 00 00 00 00 00 00
00 00 00 00 00 00 00 00
00 00 00 00 00 00 00 00
00 00 00 00 00 00 00 00
00 00 00 00 00 00 00 00

Chunk4:
00 00 00 00 00 00 00 00
00 00 00 00 00 00 00 00
00 00 00 00 00 00 00 00
00 00 00 00 00 00 00 00
00 00 00 00 00 00 00 00
00 00 00 00 00 00 00 00
00 00 00 00 00 00 00 00
16 16 16 16 16 16 16 16

Chunk5:
00 00 00 00 00 00 00 34
00 00 00 00 00 00 00 34
00 00 00 00 00 00 00 34
00 00 00 00 00 00 00 34
00 00 00 00 00 00 00 34
00 00 00 00 00 00 00 34
00 00 00 00 00 00 00 34
16 16 16 16 16 16 16 22

Chunk6:
58 58 58 58 58 58 58 50
00 00 00 00 00 00 00 34
00 00 00 00 00 00 00 34
00 00 00 00 00 00 00 34
00 00 00 00 00 00 00 34
00 00 00 00 00 00 00 34
00 00 00 00 00 00 00 34
00 00 00 00 00 00 00 34


MAP:
1 3 3 6
2 4 4 5
